#################
#               #
#    .      $   #
#         *@    #
#               #
#   $         . #
#               #
#################