   ########      
   #   #  #      
   #  $   #      
 ### #$   ####   
 #  $  ##$   #   
 #  # @ $ # $#   
 #  #      $ ####
 ## ####$##     #
 # $#.....# #   #
 #  $..**. $# ###
##  #.....#   #  
#   ### #######  
# $$  #  #       
#  #     #       
######   #       
     #####       