#######  
#.@ # #  
#$* $ #  
#   $ #  
# ..  #  
#  *  #  
#######        