         ########  
         #     @#
         # $#$ ##
         # $   $#
         ##$ $ #
 ######### $ # ###
 #....  ## $  $  #
 ##...    $  $   #
 #....  ##########
 ########